7 6 6 6 @ @ 6 6 6 6 6 6 6 6 6 7
5 @ @ @ @ @ @ @ @ @ @ @ @ @ @ 5
5 @ @ @ @ @ @ @ @ @ @ @ @ @ @ 5
5 @ @ @ @ @ @ @ @ @ @ @ @ @ @ 5
5 @ @ @ @ @ @ @ @ @ @ @ @ @ @ 5
5 @ @ @ @ @ @ @ @ @ @ @ @ @ @ 5
5 @ @ @ @ @ @ @ @ @ @ @ @ @ @ 5
5 @ @ @ @ @ @ @ @ @ @ @ @ @ @ 5
5 @ @ @ @ @ @ @ @ @ @ @ @ @ @ 5
5 @ @ @ @ @ @ @ @ @ @ @ @ @ @ 5
5 @ @ @ @ @ @ @ @ @ @ @ @ @ @ 5
7 6 6 6 6 6 6 6 6 6 6 6 6 6 6 7