3222002222222223
1000000000000001
1000000000000001
1000000000000001
1000000000000001
1000000000000001
1000000000000001
1000000000000001
1000000000000000
1000000000000000
1000000000000001
3222222222222223