0000000000000000
0000000000400000
0040000004400000
0000000000000000
0000000000040000
0000000000000000
0040000400000000
0000000400000000
0000000000000000
0000040000400000
0000000000000000
0000000000000000